111111111
1P00E01D1
10D0C0101
100000001
111111111